{
  "1": {
    "width": 8,
    "height": 8,
    "walls": [
      { "x1": 0, "y1": 1, "x2": 1, "y2": 1 },
      { "x1": 3, "y1": 3, "x2": 4, "y2": 3 },
      { "x1": 6, "y1": 6, "x2": 6, "y2": 7 },
      { "x1": 2, "y1": 2, "x2": 2, "y2": 5 },
      { "x1": 4, "y1": 1, "x2": 4, "y2": 2 },
      { "x1": 5, "y1": 4, "x2": 7, "y2": 4 },
      { "x1": 1, "y1": 5, "x2": 3, "y2": 5 },
      { "x1": 7, "y1": 2, "x2": 7, "y2": 3 }
    ]
  },
  "2": {
    "width": 6,
    "height": 4,
    "walls": [
      { "x1": 0, "y1": 1, "x2": 1, "y2": 1 },
      { "x1": 2, "y1": 2, "x2": 3, "y2": 2 },
      { "x1": 4, "y1": 3, "x2": 5, "y2": 3 },
      { "x1": 1, "y1": 0, "x2": 1, "y2": 3 },
      { "x1": 3, "y1": 1, "x2": 3, "y2": 3 },
      { "x1": 5, "y1": 0, "x2": 5, "y2": 2 }
    ]
  },
  "3": {
    "width": 5,
    "height": 5,
    "walls": [
      { "x1": 0, "y1": 1, "x2": 1, "y2": 1 },
      { "x1": 2, "y1": 2, "x2": 3, "y2": 2 },
      { "x1": 4, "y1": 3, "x2": 4, "y2": 4 },
      { "x1": 1, "y1": 0, "x2": 1, "y2": 3 },
      { "x1": 3, "y1": 1, "x2": 3, "y2": 3 },
      { "x1": 0, "y1": 4, "x2": 2, "y2": 4 },
      { "x1": 3, "y1": 0, "x2": 3, "y2": 4 }
    ]
  }
}
